############
############
############
############
##Q###D#####
#TSONMBEFP##
##R###A#####
#####HCG####
#####IJK####
######L#####
############
############